#####
#S..#
#.#.#
#.#E#
#####
