####################
#S........#...#.#.##
#.#.#####.#*###.#.##
#.#.#.............##
#.#.#.###.#.#####.##
#.#.#.#...#.....#.##
###.#####.###.#.#.##
#.#.#.......#.#.#.##
#.#.#####.#######.##
#.#.#.#....M..#...##
#.#.#.#.#.#.#####M##
#*..#...#.#..M..#.##
#######.#.#####.#.##
#.#..M..#...#.#.#.##
#.#.###.###.#.###.##
#.*...#.#.......#.##
###.###.#.#.#.######
#.....#.#.#.#.....##
##################E#
####################
