##########
#S......##
#.#.#.####
#.#.#.#.##
#####.#.##
#.......##
#####.####
#.......##
########E#
##########
