#####################
#S#..*#.....*...#...#
#.#M#.#.###########.#
#.M.#....*......#*.*#
###.#####*#####.###.#
#..**...#...#*#M.M#.#
###.###.#.###.#####.#
#.#.#*#.#.#.M*#.#..M#
#.#.#.#######.#.#.###
#...*.#..*#M.....M..#
#####.###.#.#####.###
#.M...........#.#...#
###*#.#.#.#.###*#####
#...#.#.#.#..M....M.#
#####.###.#####*#.###
#......M#.*.M*#.#..M#
#.#.###.#.###.#.#.###
#.#...#.#...#.#.#M..#
###.#.#########M#####
#...#MM*....#......E#
#####################
